111111111111111111111111111111111111111111111111111111111111111111111111111111111111111111
111111111111111111111111111111111111111111111111111111111111111111111111111111111111111111
11                                                  11                                  11
11                                                  11                                  11
11  99999999999999999999999         999999999999999 11 999999999999999         9999  99 11
11  9999999999999999999999          999999999999999 11    99999999999           999  99 11
11                    9999 11111111 999999999999999 11    999999 11 9 111111111 99 11 9 11
11                    9999 11111111 999999999999999 111111 99999 11 9 111111111 99 11 9 11
1111111111111111111111 999 11     1 999999999999999 111111 99999 11 9        11 99 11 9 11
1111111111111111111111 999 11     1 9999999999999999    11 99999 11 99       11 99 11 9 11
11      11          11 999 11 999 1      9999999999999  11 99999 11 99999999 11    11 9 11
11      11          11 999 11 999 1      999     99999  11 99999 11 99999999 11    11 9 11
11  99  11 99999999 11 999 11 999 1111111 9 11111  999  11 99999 11 99999999 11111111 9 11
11  99  11 99999999 11 999 11 999 1111111 9 11111  999  11 99999 11 99999999 11111111 9 11
11  99  11 99999999 11 999 11 999      11 9 11111  999  11 99999 11 99999999       11 9 11
11         99999999 11 999 11 9999     11 9 11111  999  11 99999 11 999999999      11 9 11
11 99999   99999999 11 999 11 99999999 11 9 11111  99999  999999 11 99999999999999 11 9 11
11 9999999999999999 11 999 11 99999999 11 9 11111  99999  999999 11 99999999999999 11 9 11
11 9999999999999999 11 999 11 99999999 11 99       9999999999999 11 99999999999999 11 9 11
11 9999999999999999 11 999 11 99999999 11 99     999999999999999 11 99999999999999 11 9 11
11 9999999999999999 11 999 11 999999999  99999999999999999999999 11 99999999999999 11 9 11
11 9999999999999999 11 999 11 999999999  999999999999999999999999  999999999999999 11 9 11
11             9999 11 999 11 999999999999999999999         9999999999999999999999 11 9 11
11             9999 11 999 11 999999999999999999999         9999999999999999999999 11 9 11
111111111111111 999   99999  999999999999999999999 111111111 99999999999      9999 11 9 11
111111111111111 999   99999  999999999999999999999 111111111 99999999999      9999 11 9 11
111111111111111 9999999999999999999999999999  9999 111111111 9999999999 11111 9999 11 9 11
111111111111111 9999  9999999999999999999999  9999 111111111 9999  9999 11111 9999 11 9 11
11              9999  999999999999999999999 11 9999         99999  9999 11111 99999  99 11
11             9999 11 9999        99999999 11 9999         9999 11 999 11111 99999  99 11
11 9999999999999999 11 9999        99999999 11 99999999999999999 11 999 11111 999999999 11
11 9999999999999999 11 999 11111111 9999999 11 99999999999999999 11 999 11111 999999999 11
11 9999999999999999 11 999 11111111 9999999 11 999          9999 11 999 11111 999999999 11
11 9999999999999999 11 999       11 9999999 11 99           9999 11 999 11111111 999999 11
11 9999999999999999 11 9999      11 9999999 11 999 111111111 999 11 999 11111111 999999 11
11 999  99999999999 11 999999999 11 9999999 11 999 111111111 999 11 999 11111111 999999 11
11 999  99999999999 11 999999999 11    9999 11 999 111111111 999 11 999 11111111 999999 11
11 99 11 9999999999 11 999999999 111111 999 11 999 111111111 999 11 9999      11 999999 11
11 99 11 9999999999 11 999999999 111111 999 11 9999         9999 11 9999      11 999999 11
11 99 11 9999999999 11 999999999     11 999 11 99999        9999 11 999999999 11 999999 11
11 99 11 9999999999 11 999999999     11 999 11 99999999999999999 11 999999999 11 999999 11
11 99 11       9999 11 9999999999999 11 999 11 99999999999999999 11 999999999 11 999999 11
11 99 11       9999 11 9999999999999 11 999 11 9999         9999 11 999999999 11 999999 11
11 99 111111111 9999  99999999999999 11 999 11 9999         9999 11 999999999 11 999999 11
11 99 111111111 9999  99999999999999 11 999 11 999 111111111 999    9999999   11 999999 11
11 99 111111111 99999999999999999999    999 11 999 111111111 999    9999999   11 999999 11
11    111111111                             11     111111111                  11        11
11    111111111                             11     111111111                  11        11
111111111111111111111111111111111111111111111111111111111111111111111111111111111111111111
111111111111111111111111111111111111111111111111111111111111111111111111111111111111111111