111111111111111111111111111111111111111111111111111111111111111111111111111111111111111111
111111111111111111111111111111111111111111111111111111111111111111111111111111111111111111
11                                                  11                                  11
11                                                  11                                  11
11                                                  11                                  11
11                                                  11                                  11
11                         11111111                 11           11   111111111    11   11
11                         11111111                 111111       11   111111111    11   11
1111111111111111111111     11     1                 111111       11          11    11   11
1111111111111111111111     11     1                     11       11          11    11   11
11      11          11     11     1                     11       11          11    11   11
11      11          11     11     1                     11       11          11    11   11
11      11          11     11     1111111   11111       11       11          11111111   11
11      11          11     11     1111111   11111       11       11          11111111   11
11      11          11     11          11   11111       11       11                11   11
11                  11     11          11   11111       11       11                11   11
11                  11     11          11   11111                11                11   11
11                  11     11          11   11111                11                11   11
11                  11     11          11                        11                11   11
11                  11     11          11                        11                11   11
11                  11     11                                    11                11   11
11                  11     11                                                      11   11
11                  11     11                                                      11   11
11                  11     11                                                      11   11
111111111111111                                    111111111                       11   11
111111111111111                                    111111111                       11   11
111111111111111                                    111111111            11111      11   11
111111111111111                                    111111111            11111      11   11
11                                          11                          11111           11
11                  11                      11                   11     11111           11
11                  11                      11                   11     11111           11
11                  11     11111111         11                   11     11111           11
11                  11     11111111         11                   11     11111           11
11                  11           11         11                   11     11111111        11
11                  11           11         11     111111111     11     11111111        11
11                  11           11         11     111111111     11     11111111        11
11                  11           11         11     111111111     11     11111111        11
11    11            11           111111     11     111111111     11           11        11
11    11            11           111111     11                   11           11        11
11    11            11               11     11                   11           11        11
11    11            11               11     11                   11           11        11
11    11            11               11     11                   11           11        11
11    11            11               11     11                   11           11        11
11    111111111                      11     11                   11           11        11
11    111111111                      11     11     111111111                  11        11
11    111111111                             11     111111111                  11        11
11    111111111                             11     111111111                  11        11
11    111111111                             11     111111111                  11        11
111111111111111111111111111111111111111111111111111111111111111111111111111111111111111111
111111111111111111111111111111111111111111111111111111111111111111111111111111111111111111